NO ./textures/stone.xpm



SO ./textures/brick_with_flag.xpm



WE ./textures/stone_musgo.xpm



EA ./textures/wood.xpm



C 0,150,255

F 0,255,0



1111  1111111111
1001111000110001
1011000001110001
100100N000000001
1000011011000001
1111111111111111
