NO ./textures/stone.xpm



SO ./textures/brick_with_flag.xpm



WE ./textures/stone_musgo.xpm



EA ./textures/brick.xpm



C 0,150,255

F 52,140,49



1111  1111111111
1001111000010001
1011000000010001
1011000111110001
100100S000000001
1001000000000001
1000011011000001
1111111111111111
